#AI 1.0
UTG = "countries/Ustyug.txt"
KBN = "countries/Kubena.txt"
AQL = "countries/LAquila.txt"
VDM = "countries/Vaudemont.txt"
NPR = "countries/NaplesRepublic.txt"
OTR = "countries/Otranto.txt"
ANO = "countries/Ariano.txt"
ABN = "countries/AngevinAlbania.txt"
CNB = "countries/Canterbury.txt"
CSR = "countries/Cheshire.txt"
GCS = "countries/Gloucester.txt"
SMS = "countries/Somerset.txt"
SBY = "countries/Salisbury.txt"
DEV = "countries/Devon.txt"
LNL = "countries/Lincoln.txt"
HMP = "countries/Hampshire.txt"
KEN = "countries/Kent.txt"
SSX = "countries/Sussex.txt"
ESX = "countries/Essex.txt"
SFK = "countries/Suffolk.txt"
NFK = "countries/Norfolk.txt"
LNC = "countries/Lancaster.txt"
YRK = "countries/York.txt" 
SRR = "countries/Sarrebourg.txt"
SOI = "countries/Soissons.txt"
NIM = "countries/Nimes.txt"
VNN = "countries/Vienne.txt"
GAP = "countries/Gap.txt"
GJI = "countries/GuernseyJersey.txt"
PTH = "countries/Ponthieu.txt"
FCQ = "countries/Forcalquier.txt"
TNE = "countries/Turenne.txt"
CTR = "countries/Castres.txt"
CNU = "countries/Cornouaille.txt"
EVR = "countries/Evreux.txt"
MRT = "countries/Mortain.txt"
LAO = "countries/Laon.txt"
CLR = "countries/Clermont.txt"
CSL = "countries/Chalons.txt"
BVS = "countries/Beauvais.txt"
RMS = "countries/Reims.txt"
LGR = "countries/Langres.txt"
ESK = "countries/BasqueCountry.txt"
BSP = "countries/BasqueSpain.txt"
TUD = "countries/Tudela.txt"
ETA = "countries/Etampes.txt"
LBD = "countries/Labourd.txt"
ASR = "countries/UnitedAsturias.txt"
CTB = "countries/Cantabria.txt"
MRG = "countries/Molina.txt"
GBL = "countries/Gibraltar.txt"
GDA = "countries/Guarda.txt"
OCS = "countries/Christ.txt"
CNR = "countries/SpanishCanaries.txt"
AB2 = "countries/Alburquerque2.txt"
PNF = "countries/Penafiel.txt"
ABQ = "countries/Alburquerque.txt"
SGV = "countries/Segovia.txt"
AAV = "countries/Avila.txt"
WFL = "countries/Warffala.txt"
QAN = "countries/Qantrar.txt"
SAY = "countries/Say.txt" 
MDC = "countries/Modica.txt"
GMR = "countries/Gomera.txt"
CRY = "countries/Canaria.txt"
NIE = "countries/Niebla.txt"
TTA = "countries/Trastamara.txt"
SLM = "countries/Salamanca.txt"
RBG = "countries/Ribagorza.txt"
GDI = "countries/Gandia.txt"
MDS = "countries/MedinaSidonia.txt"
ALJ = "countries/Alentejo.txt"
BIA = "countries/Beira.txt"
OPO = "countries/Porto.txt"
BVE = "countries/Benavente.txt"
TLL = "countries/Trujillo.txt"
VLL = "countries/Villena.txt"
SRI = "countries/Soria.txt"
VLD = "countries/Valladolid.txt"
BGS = "countries/Burgos.txt"
PLS = "countries/Plasencia.txt"
CMB = "countries/Coimbra.txt"
VEU = "countries/Viseu.txt"
BGZ = "countries/Braganza.txt"
ALV = "countries/Alava.txt"
GPK = "countries/Gipuzkoa.txt"
ATR = "countries/Atri.txt"
VAD = "countries/Vaud.txt"
SCI = "countries/SicilyPiedmont.txt"
BLL = "countries/Belley.txt" 
BSE = "countries/Bresse.txt"
GVS = "countries/Genevois.txt"
SCM = "countries/Schaunberg.txt"
FIU = "countries/RealAquileia.txt"
TSA = "countries/Thessalonica.txt"
BGO = "countries/Boglio.txt"
VLI = "countries/Vercelli.txt"
PIA = "countries/Piacenza.txt"
LOD = "countries/Lodi.txt"
RMG = "countries/Romagna.txt"
AIN = "countries/Ainos.txt"
LVN = "countries/LombardyVenetia.txt"
CFP = "countries/Cephalonia.txt"
MEA = "countries/LatinMorea.txt"
ORS = "countries/Oristano.txt"
LWW = "countries/LowerLusatia.txt"
ARZ = "countries/Arezzo.txt"
SRA = "countries/Sora.txt"
MRC = "countries/Marche.txt"
BNO = "countries/Belluno.txt"
STI = "countries/Split.txt"
RTI = "countries/Rieti.txt"
ORV = "countries/Orvieto.txt"
FLG = "countries/Foligno.txt"
CVC = "countries/Civitavecchia.txt"
CMO = "countries/Como.txt"
BLZ = "countries/Bellinzona.txt"
BDI = "countries/Bardi.txt"
CRM = "countries/Cremona.txt"
PVI = "countries/Pavia.txt"
ONG = "countries/Oneglia.txt"
SIN = "countries/Sion.txt"
BRC = "countries/Brescia.txt"
TVO = "countries/Treviso.txt"
VNA = "countries/Verona.txt"
TNI = "countries/Terni.txt"
SPT = "countries/Spoleto.txt"
FMO = "countries/Fermo.txt"
RMA = "countries/Roma.txt"
AVL = "countries/Avellino.txt"
BNV = "countries/Benevento.txt"
BLC = "countries/Basilicata.txt"
ARI = "countries/Bari.txt"
ADI = "countries/Andria.txt"
LCC = "countries/Lecce.txt"
SLR = "countries/Salerno.txt"
APL = "countries/Apulia.txt"
MSE = "countries/Molise.txt"
AZZ = "countries/Abruzzo.txt"
CPA = "countries/Capua.txt"
CBR = "countries/Calabria.txt"
VIV = "countries/Viviers.txt"
VLY = "countries/Velay.txt"
ABG = "countries/Albi.txt"
CRS = "countries/Carcassonne.txt"
MTP = "countries/Montpellier.txt"
GEV = "countries/Gevaudan.txt"
BGR = "countries/Bigorre.txt"
OCC = "countries/Occitania.txt"
ROU = "countries/Rouergue.txt"
WLN = "countries/Wallonia.txt"
PGD = "countries/Perigord.txt"
LYN = "countries/Lyon.txt"
FRZ = "countries/Forez.txt"
PRC = "countries/Perche.txt"
DNO = "countries/Dunois.txt"
NEM = "countries/Nemours.txt"
RSL = "countries/Rousillon.txt"
AUN = "countries/Aunis.txt"
STN = "countries/Saintonge.txt"
GYN = "countries/Guyenne.txt"
NRB = "countries/Narbonne.txt"
BOI = "countries/Blois.txt"
VLS = "countries/Valois.txt"
CTL = "countries/Chatellerault.txt"
ALY = "countries/Arlay.txt"
MCN = "countries/Macon.txt"
BOG = "countries/Boulogne.txt"
GUI = "countries/Guise.txt"
SDG = "countries/Sundgau.txt"
RTL = "countries/Rethel.txt"
CHS = "countries/Charolais.txt"
FIE = "countries/FrieslandLordship.txt"
JEV = "countries/Jever.txt"
OMM = "countries/Ommelanden.txt"
JCB = "countries/JulichClevesBerg.txt"
SCH = "countries/Schwerin.txt"
RVB = "countries/Ravensberg.txt"
BRL = "countries/BrunswickLuneburg.txt"
HSF = "countries/Hersfeld.txt"
NDD = "countries/Nidda.txt"
KSS = "countries/Kassel.txt"
FBG = "countries/Freiburg.txt"
BGU = "countries/Burgau.txt"
STT = "countries/Stuttgart.txt"
URC = "countries/Urach.txt"
PNS = "countries/Pronsk.txt"
YTS = "countries/Yelets.txt"
MSK = "countries/Mosalsk.txt"
BLY = "countries/Belyov.txt"
KZK = "countries/Kozelsk.txt"
KCH = "countries/Karachev.txt"
VNS = "countries/Vorotynsk.txt"
SWB = "countries/SaxeWittenberg.txt"
WED = "countries/Weida.txt"
GLL = "countries/SaintGall.txt"
ERF = "countries/Erfurt.txt"
LWL = "countries/Lothier.txt"
HSM = "countries/Marburg.txt"
NBG = "countries/Neuburg.txt"
WEL = "countries/Weilburg.txt"
BRD = "countries/Breda.txt"
ESS = "countries/Essen.txt"
STS = "countries/Strassburg.txt"
ASC = "countries/BigAlsace.txt"
KLO = "countries/Koln.txt"
LWS = "countries/LowerSaxony.txt"
MBD = "countries/Montbeliard.txt"
CNT = "countries/Carinthia.txt"
FCB = "countries/FrancheComte.txt"
SVG = "countries/Slesvig.txt"
MSN = "countries/Messin.txt"
CRL = "countries/CourlandSemigallia.txt"
LVO = "countries/FennicLivonia.txt"
FRO = "countries/Faroes.txt"
AIB = "countries/Aiboland.txt"
OBT = "countries/Ostrobothnia.txt"
OTL = "countries/Eastland.txt"
SKN = "countries/Scania.txt"
VYS = "countries/Vyshnivets.txt"
BCW = "countries/Bratslav.txt"
SDZ = "countries/Sandomierz.txt"
MKK = "countries/Mark.txt"
GTH = "countries/Gotha.txt"
WEM = "countries/Weimar.txt"
UPH = "countries/UpperHungary.txt"
PLV = "countries/Polabia.txt"
PRW = "countries/RealRawa.txt"
CZE = "countries/Czersk.txt"
SIZ = "countries/Sieradz.txt"
CHN = "countries/Chelmno.txt"
LCS = "countries/Lecyca.txt"
KYV = "countries/Kuyavia.txt"
NYS = "countries/Nysa.txt"
AUZ = "countries/Auschwitz.txt"
BYM = "countries/Bytom.txt"
WCW = "countries/Breslau.txt"
RTB = "countries/Ratibor.txt"
SWD = "countries/Swidnica.txt"
JAW = "countries/Jawor.txt"
GTZ = "countries/Glatz.txt"
TCH = "countries/Teschen.txt"
TPL = "countries/Tropau.txt"
OEL = "countries/Oels.txt" 
BZG = "countries/Brzeg.txt"
LGN = "countries/Liegnitz.txt"
ZAG = "countries/Sagan.txt"
ULT = "countries/UpperLusatia.txt"
WHH = "countries/WhiteHorde.txt"
UBY = "countries/Ubykh.txt"
ZHY = "countries/Zhaney.txt"
ABZ = "countries/Abazinia.txt"
ABK = "countries/Abkhazia.txt"
AOS = "countries/Aosta.txt"
SVY = "countries/PiedmonteseSavoy.txt"
NIC = "countries/Nice.txt"
EPS = "countries/Empuries.txt"
UGL = "countries/Urgell.txt"
GRD = "countries/SpanishGranada.txt"
BEA = "countries/Bearn.txt"
BSC = "countries/Biscay.txt"
IBE = "countries/Iberia.txt"
TDL = "countries/Tadla.txt"
DKK = "countries/Doukkala.txt"
AMZ = "countries/Amzouar.txt"
CHF = "countries/Chefchaouen.txt"
DBD = "countries/Debdou.txt"
SIQ = "countries/Siqiliyyah.txt"
TTR = "countries/Tortosa.txt"
SMH = "countries/TaifaHarun.txt"
UMY = "countries/Umayyad.txt"
ISB = "countries/TaifaSeville.txt"
MCI = "countries/TaifaMurcia.txt"
BDJ = "countries/TaifaBadajoz.txt"
TVL = "countries/TaifaValencia.txt"
TLE = "countries/TaifaToledo.txt"
ZRZ = "countries/TaifaZaragoza.txt"
MJC = "countries/TaifaMajorca.txt"
ARR = "countries/TaifaAlbarracin.txt" 
TMS = "countries/Temes.txt"
KPS = "countries/Kopsis.txt"
KRN = "countries/Kran.txt"
ILY = "countries/Illyria.txt"
SLV = "countries/Slavonia.txt"
FRK = "countries/Krk.txt"
JON = "countries/Jonima.txt"
AIA = "countries/Arianiti.txt"
SID = "countries/Sidon.txt"
GLI = "countries/Galilee.txt"
JAF = "countries/Jaffa.txt"
OUL = "countries/Oultrejordain.txt"
ATC = "countries/Antioch.txt"
EDS = "countries/Edessa.txt"
TRL = "countries/LatinTripoli.txt"
GOK = "countries/Goksun.txt"
AHI = "countries/Ahi.txt"
HMD = "countries/Hamid.txt"
IFR = "countries/Ifriqiya.txt"
CRG = "countries/CrnaGora.txt"
KBD = "countries/Kubad.txt"
TCT = "countries/Tacettin.txt"
BFR = "countries/Bafra.txt"
HCM = "countries/Haciem.txt"
ATO = "countries/MountAthos.txt"
KRS = "countries/Karasi.txt"
ARV = "countries/Arvanitia.txt"
ARO = "countries/Arumania.txt"
CSA = "countries/Csangoland.txt"
MRM = "countries/Marmatia.txt"
CRV = "countries/Craiova.txt"
SBL = "countries/SevenCastles.txt"
TSL = "countries/RomanianTransylvania.txt"
YGS = "countries/Yugoslavia.txt"
PLP = "countries/Prilep.txt"
VLB = "countries/Velbazhd.txt"
DBJ = "countries/Dobruja.txt"
TNV = "countries/Tarnovo.txt"
THB = "countries/Thebes.txt"
NPT = "countries/Neopatras.txt"
GLW = "countries/Galway.txt"
ELY = "countries/Ely.txt" 
KRR = "countries/Kerry.txt"
LST = "countries/OverLeinster.txt"
UST = "countries/OverUlster.txt"
MNT = "countries/OverMunster.txt"
CNH = "countries/OverConnacht.txt"
NBL = "countries/Northumberland.txt"
NVL = "countries/Neville.txt"
AGS = "countries/Angus.txt"
DUN = "countries/Dunbar.txt"
MRS = "countries/Mar.txt"
DUG = "countries/Douglas.txt"
SPN = "countries/HabsburgSpain.txt"
NPO = "countries/Naples2.txt"
MLN = "countries/AmbrosianMilan.txt"
SAP = "countries/Saint-Pol.txt"
SWY = "countries/Schwyz.txt"
LUZ = "countries/Luzern.txt"
BRN = "countries/Bern.txt"
ZUR = "countries/Zurich.txt"
LNN = "countries/Lausanne.txt"
ALC = "countries/Alcantara.txt"
STJ = "countries/SaintJohn.txt"
STG = "countries/Santiago.txt" 
CLT = "countries/Calatrava.txt"
MTA = "countries/Mantesa.txt"
STL = "countries/Sant'lago.txt"
AVZ = "countries/Aviz.txt"
BRV = "countries/BremenVorde.txt"
EUF = "countries/Eu.txt"
CMG = "countries/Comminges.txt"
RTZ = "countries/Retz.txt"
FNS = "countries/Finistere.txt"
LVL = "countries/Laval.txt"
LAM = "countries/LaMarche.txt"
STM = "countries/SaintMalo.txt"
BZH = "countries/Breizh.txt"
TNN = "countries/Tonnerre.txt"
SNC = "countries/Sancerre.txt"
VDO = "countries/Vendome.txt"
AGL = "countries/Angouleme.txt"
KTZ = "countries/Katzenelnbogen.txt"
OVJ = "countries/Overijssel.txt"
DRT = "countries/Drenthe.txt"
NFR = "countries/NorthFrisia.txt"
DPR = "countries/DucalPrussia.txt"
DLL = "countries/Dillenburg.txt"
SIG = "countries/Siegen.txt"
WIE = "countries/Wiesbaden.txt"
SPE = "countries/SpeyerFreeCity.txt"
RYP = "countries/RoyalPrussia.txt"
HLS = "countries/Hlynsk.txt"
DKG = "countries/Dukagjini.txt"
GRP = "countries/Debar.txt"
GZR = "countries/Gazaria.txt"
ANI = "countries/AngloIreland.txt" #from BT
ANJ = "countries/Anjou.txt"
UQB = "countries/Uqba.txt"
MHI = "countries/Mahri.txt"
HWH = "countries/Hawwarah.txt"
WAH = "countries/Wahat.txt"
KEM = "countries/Kmt.txt"
BJA = "countries/Bejaia.txt"
GFS = "countries/Gafsa.txt"
ZEE = "countries/Zeeland.txt"
AIT = "countries/AitAbbas.txt"
CST = "countries/Constantine.txt"
ORN = "countries/Oran.txt"
RIF = "countries/Rif.txt"
SAI = "countries/Shawia.txt"
SHW = "countries/Shenwa.txt"
ORK = "countries/Orkney.txt"
VBG = "countries/Viborg.txt"
BKL = "countries/Birkarland.txt"
JMT = "countries/Jamtland.txt"
AFR = "countries/Africa.txt"
YTV = "countries/Yotvingia.txt"
BSS = "countries/Borussia.txt"
PMR = "countries/Pomerelia.txt"
REV = "countries/Reval.txt"
OSL = "countries/Osel-Wiek.txt"
DRP = "countries/Dorpat.txt"
ABT = "countries/Albret.txt"
NMK = "countries/Neumarkt.txt"
MBC = "countries/Mosbach.txt"
KSR = "countries/Kaiserslautern.txt"
ZWE = "countries/Zweibrucken.txt"
CBM = "countries/Cambrai.txt"
TRN = "countries/Touraine.txt"
VLN = "countries/Valentinois.txt"
MNE = "countries/Maine.txt"
LIM = "countries/Limousin.txt"
POI = "countries/Poitou.txt"
WLM = "countries/WelshMarch.txt"
DUR = "countries/Durham.txt"
MTZ = "countries/Metz.txt"
TLO = "countries/Toul.txt"
VDN = "countries/Verdun.txt"
HGE = "countries/Hagenau.txt"
KML = "countries/Kolmar.txt"
WIS = "countries/Wissemburg.txt"
SLS = "countries/Schlettstadt.txt"
ABR = "countries/Arborea.txt"
CSS = "countries/CorsicaSardinia.txt"
ATS = "countries/Artois.txt"
TOA = "countries/Tournai.txt"
NAM = "countries/Namur.txt"
BSA = "countries/Besancon.txt"
GRN = "countries/Groningen.txt"
PUM = "countries/Prum.txt"
SAA = "countries/Saarbrucken.txt"
SPY = "countries/Speyer.txt"
WOR = "countries/Worms.txt"
SPH = "countries/Sponheim.txt"
BSL = "countries/Basel.txt"
ZDN = "countries/Zenden.txt"
NUC = "countries/Neuchatel.txt"
GRU = "countries/Gruyere.txt"
FRB = "countries/Fribourg.txt"
SGL = "countries/StGallen.txt"
GHB = "countries/Gotteshausbund.txt"
GRB = "countries/Grauerbund.txt"
ATI = "countries/Asti.txt"
PIE = "countries/Piedmont.txt"
MSS = "countries/Massa.txt"
PIO = "countries/Piombino.txt"
CDC = "countries/CittadiCastello.txt"
MTS = "countries/Malatesta.txt"
FNZ = "countries/Faenza.txt"
FRL = "countries/Forli.txt"
RAV = "countries/Ravenna.txt"
PSR = "countries/Pesaro.txt"
ANC = "countries/Ancona.txt"
CMR = "countries/Camerino.txt"
TUC = "countries/Tuscia.txt"
VLT = "countries/Velletri.txt"
SVO = "countries/Savona.txt"
RAN = "countries/Taranto.txt"
ALR = "countries/Alatri.txt"
ANR = "countries/Antrim.txt"
BIF = "countries/Breifne.txt"
CLN = "countries/Clandeboye.txt"
ECO = "countries/EastConnacht.txt"
FGH = "countries/Fermanagh.txt"
MGH = "countries/Monaghan.txt"
IVE = "countries/Iveagh.txt"
MYO = "countries/Mayo.txt"
WCO = "countries/WestConnacht.txt"
HYM = "countries/HyMany.txt"
GRZ = "countries/Gorizia.txt"
TST = "countries/Trieste.txt"
CNL = "countries/Carniola.txt"
RIJ = "countries/Rijeka.txt"
ORT = "countries/Ortenburg.txt"
BRX = "countries/Brixen.txt"
IST = "countries/Istria.txt"
JUL = "countries/Julich.txt"
KMI = "countries/Kammin.txt"
STP = "countries/Stolp.txt"
BAT = "countries/Barth.txt"
STR = "countries/Stargard.txt"
HAV = "countries/Havelberg.txt"
WDE = "countries/Wende.txt"
VOG = "countries/Vogtland.txt"
SCW = "countries/Schwarzburg.txt"
FRG = "countries/Freising.txt"
STB = "countries/Straubing.txt"
BCH = "countries/Berchtesgaden.txt"
RTW = "countries/Rottweil.txt"
OFF = "countries/Offenburg.txt"
KMP = "countries/Kempten.txt"
FST = "countries/Furstenberg.txt"
WLD = "countries/Waldburg.txt"
REU = "countries/Reutlingen.txt"
DRM = "countries/Darmstadt.txt"
H4L = "countries/Hall.txt"
HEL = "countries/Heilbronn.txt"
NRD = "countries/Nordlingen.txt"
SCN = "countries/Schweinfurt.txt"
WEI = "countries/Weissenburg.txt"
MHN = "countries/Muhlhausen.txt"
HNB = "countries/Henneberg.txt"
ZIE = "countries/Ziegenhein.txt"
WLK = "countries/Waldeck.txt"
MND = "countries/Minden.txt"
FLD = "countries/Fulda.txt"
HLB = "countries/Halberstadt.txt"
HLD = "countries/Hildesheim.txt"
BTH = "countries/Bentheim.txt"
TCK = "countries/Tecklenburg.txt"
HOY = "countries/Hoya.txt"
GTT = "countries/Gottingen.txt"
DJK = "countries/DonjiKraji.txt"
PVC = "countries/Pavlovac.txt"
BTR = "countries/Berat.txt"
VLO = "countries/Valona.txt"
KTR = "countries/Kotor.txt"
KST = "countries/Kastrioti.txt"
SCR = "countries/Scuria.txt"
GJR = "countries/Gjirokaster.txt"
SZK = "countries/Szekelyfold.txt"
CUM = "countries/Cumania.txt"
USR = "countries/Usora.txt"
BDN = "countries/Vidin.txt"
LOV = "countries/Lovech.txt"
RTA = "countries/Arta.txt"
TSK = "countries/Thessaloniki.txt"
CDA = "countries/Candia.txt"
LES = "countries/Lesbos.txt"
NEG = "countries/Negroponte.txt"
CIO = "countries/Chios.txt"
TKK = "countries/Tekke.txt"
CIK = "countries/Canik.txt"
KLI = "countries/Kilis.txt"
ALI = "countries/Alaiye.txt"
CAE = "countries/Canaries.txt"
GUN = "countries/Guanche.txt"
MFR = "countries/MagnaFrisia.txt"
LTE = "countries/LatinEmpire.txt"
PLL = "countries/Pallars.txt"
ZUT = "countries/Zutphen.txt"
LGH = "countries/Laghouat.txt"
OGL = "countries/Ouargla.txt"
CAA = "countries/Chaamba.txt"
DRA = "countries/Draa.txt"
TZA = "countries/Tazerwalt.txt"
GRV = "countries/Algarve.txt"
SVL = "countries/Seville.txt"
CDB = "countries/Cordoba.txt"
JAE = "countries/Jaen.txt"
MUR = "countries/Murcia.txt"
TLD = "countries/Toledo.txt"
STV = "countries/Stavelot.txt"
KUM = "countries/Kulm.txt"
PMS = "countries/Pomesania.txt"
SMA = "countries/Sambia.txt"
WRM = "countries/Warmia.txt"
CLC = "countries/Cilicia.txt"
CAP = "countries/Cappadocia.txt"
ROC = "countries/RepublicofCyprus.txt"
RAW = "countries/Rawa.txt"
PDL = "countries/Podolia.txt"
SMG = "countries/Samogitia.txt"
SLT = "countries/Slutsk.txt"
MST = "countries/Mstislav.txt"
BRY = "countries/Bryansk.txt"
HLY = "countries/Halych.txt"
ROH = "countries/Rohan.txt"
PHV = "countries/Penthievre.txt"
GTA = "countries/Gotaland.txt"
BSM = "countries/BanuSulaym.txt"
AJJ = "countries/Ajjer.txt"
NAF = "countries/Infusen.txt"
JUF = "countries/Jufra.txt"
TOO = "countries/Toubou.txt"
BQA = "countries/Barqa.txt"
KTG = "countries/Kaitag.txt"
ZIK = "countries/Zirikhgeran.txt"
TBN = "countries/Tabasaren.txt"
LEK = "countries/Lekia.txt"
VNK = "countries/Vainakhia.txt"
ALN = "countries/Alania.txt"
KCY = "countries/Karachay.txt"
BLK = "countries/Balkaria.txt"
LBG = "countries/Limburg.txt"
MEC = "countries/Mechelen.txt"
LOO = "countries/Loon.txt"
ANW = "countries/Antwerp.txt"
GNT = "countries/Gent.txt"
AKH = "countries/Akhty.txt"
VGU = "countries/Voguls.txt"
MRZ = "countries/Murunza.txt"
MLZ = "countries/Malmyzh.txt"
KR2 = "countries/Karin.txt"
KRU = "countries/Kursk.txt"
TVR = "countries/Turov.txt"
OSG = "countries/Ostrog.txt"
ZWO = "countries/Zwolle.txt"
RIA = "countries/Mari.txt"
VYA = "countries/Vyatka.txt"
VYC = "countries/Vychegda.txt"
ZVE = "countries/Zvenigorod.txt"
MOZ = "countries/Mozhaysk.txt"
TRU = "countries/Tarusa.txt"
SEP = "countries/Serpukhov.txt"
DMI = "countries/Dmitrov.txt"
SUA = "countries/Shuya.txt"
BEZ = "countries/Bezhetsk.txt"
RZH = "countries/Rzhev.txt"
HEX = "countries/Hexhamshire.txt"
AOR = "countries/Andorra.txt"
SEO = "countries/Segorbe.txt"